##################
#P.......#.......#
#.######.#.#####.#
#.#....#.#.....#.#
#.#.C..#...C...#.#
#.#.#########..#.#
#.#.......#....#.#
#.#.C.....#.E..#.#
#....C......C....#
##################