#####################
#P......#...........#
#.#####.#.#########.#
#.....#.#.#.......#.#
###.#.#.#.#.#####.#.#
#...#.#.#.#.....#.#.#
#.###.#.#.#####.#.#.#
#.#...#.#.....#.#.#.#
#.#.###.#####.#.#.#.#
#.#....C....#.#.#.#.#
#.#########.#.#.#.#.#
#....E....#...#...#.#
#..C...C....C...C...#
#####################