#############
#E....#..P..#
#.....#..C..#
#.....#.....#
#..C........#
#.......##.##
#...........#
#........C..#
#############