##############
#P...........#
#..######....#
#.......C....#
#............#
#..C.........#
#......#######
#............#
#..E....C..C.#
##############