##########
#P...C...#
#........#
#...#....#
#....#...#
#..C...E.#
#........#
#...C....#
##########